abend	abend
essen	essen
affe	affen
apfel	apfel
ameise	ameisen
arbeit	arbeit
arm	arm
auge	augen
auto	auto
banane	bananen
baum	baum
bank	bank
becher	becher
besen	besen
bett	bett
bild	bild
buch	buch
bücher	bücher
birne	birnen
bad	bade
zimmer	zimmer
bagger	bagger
ball	ball
bär	bär
bauch	bauch
bein	bein
biene	bienen
blatt	blatt
blätter	blätter
blume	blumen
bohnen	bohnen
bohne	bohnen
bonbon	bonbon
boot	boot
brille	brillen
brot	brot
bürste	bürsten
bus	bus
bürsten	bürsten
butter	butter
couch	couch
dach	dach
decke	decken
decken	decken
deckel	deckel
dose	dosen
durst	durst
dusche	dusch
eier	eier
ei	eier
eimer	eimer
eis	eis
eisen	eisen
bahn	bahn
elefant	elefanten
ente	enten
erbsen	erbsen
erdbeere	erdbeeren
beere	beeren
beeren	beeren
esel	esel
eule	eulen
eulen	eulen
fahrrad	fahrrad
fahrräder	fahrräder
fenster	fenster
fernseher	fernseher
finger	finger
fisch	fisch
flasche	flaschen
fleisch	fleisch
fliege	fliegen
fliegen	fliegen
flug	flug
zeug	zeug
frosch	frosch
fuß	fuß
gabel	gabel
gans	gans
garten	garten
geschichte	geschichten
gesicht	gesichts
giraffe	giraffen
glas	glas
gras	gras
gurke	gurken
gürtel	gürtel
haare	haaren
hahn	hahn
hammer	hammer
hand	hand
tuch	tuch
hase	hasen
haus	haus
schuhe	schuhe
schuh	schuh
hemd	hemd
herd	herd
himmel	himmel
honig	honig
hose	hosen
schraube	schrauben
huhn	huhn
hund	hunde
jacke	jacken
junge	jungen
käfer	käfer
kamm	kamm
kartoffel	kartoffel
käse	käse
katze	katzen
keks	keks
keller	keller
kette	ketten
kinder	kinder
wagen	wagen
kinn	kinn
kissen	kissen
kleid	kleid
kleider	kleider
knie	knie
knopf	knopf
kopf	kopf
krokodil	krokodil
küche	küchen
kuchen	kuchen
kuh	kuh
kühlschrank	kühlschrank
schrank	schrank
küken	küken
lampe	lampen
leiter	leiter
leute	leuten
licht	licht
löffel	löffel
löwe	löwen
lutscher	lutscher
mädchen	mädchen
mann	mann
mantel	mantel
marmelade	marmeladen
maus	maus
melone	melonen
messer	messer
milch	milch
mittag	mittags
mond	mond
motorrad	motorrad
mund	mund
musik	musik
mütze	mützen
nacht	nacht
nagel	nagel
nase	nasen
nudel	nudel
nuss	nuss
ofen	ofen
ohr	ohr
oma	oma
opa	opa
papa	papa
mama	mama
papier	papier
park	park
pferd	pferde
platz	platz
popo	popo
pudding	pudding
pullover	pullover
puppe	puppen
regen	regen
reh	reh
rutsche	rutschen
saft	saft
salz	salz
sand	sand
kasten	kasten
schaf	schaf
schal	schal
schaufel	schaufel
schaukel	schaukel
schere	scheren
schiff	schiffs
schlaf	schlaf
schlüssel	schlüssel
schmetterling	schmetterlings
schnecke	schnecken
schnuller	schnuller
schokolade	schokoladen
schüssel	schüssel
schwein	schweine
seife	seifen
socken	socken
sofa	sofa
sonne	sonnen
soße	soßen
spaghetti	spaghetti
spiel	spiel
spinnen	spinnen
steine	steine
sterne	sterne
stiefel	stiefel
stift	stift
stock	stock
straße	straßen
stuhl	stuhl
suppe	suppen
tag	tag
tankstelle	tankstellen
tasse	tassen
wald	wald
maschine	maschinen
wasser	wasser
weintrauben	weintrauben
wind	wind
windel	windel
wolf	wolfs
wolke	wolken
wurst	wurst
zahn	zahn
zähne	zähne
zebra	zebra
zehe	zehen
zeitung	zeitungs
zug	zug
zunge	zungen
teddy	teddy
tee	tee
telefon	telefon
handy	handy
teller	teller
tier	tier
tiger	tiger
tisch	tisch
tomate	tomaten
topf	topf
traktor	traktor
treppe	treppen
tür	tür
turm	turm
uhr	uhr
unterhose	unterhosen
vogel	vogel
vorsicht	vorsicht
creme	creme
computer	computer
cola	cola
city	city
muster	muster
staat	staat
freiheit	freiheits
gebäude	gebäude
erfolg	erfolgs
geld	geld
rettung	rettungs
bargeld	bargeld
schlacht	schlacht
feier	feier
gebiet	gebiet
wurzel	wurzel
wache	wache
drohung	drohungs
gipfel	gipfel
einfluss	einfluss
sphäre	sphären
gewalt	gewalt
lust	lust
richtung	richtung
satz	satz
schnitt	schnitt
wendung	wendungs
zweifel	zweifel
speicher	speicher
draht	draht
pflicht	pflicht
lager	lager
ausbruch	ausbruchs
sorge	sorgen
streit	streit
korb	korb
schuld	schulden
gegner	gegner
stachel	stachel
betrag	betrags
bedingung	bedingungs
schub	schub
ordner	ordner
flut	flut
versuch	versuchs
nachteil	nachteil
wert	wert
faden	faden
ausgang	ausgangs
koffer	koffer
feld	feld
ablehnung	ablehnungs
achtel	achtel
neuntel	neuntel
viertel	viertel
fünftel	fünftel
sechstel	sechstel
siebtel	siebtel
drittel	drittel
liebe	liebes
dichter	dichter
müll	müll
denkmal	denkmal
sackgasse	sackgassen
zweig	zweig
mais	mais
schatten	schatten
staub	staub
witz	witz
glauben	glauben
hafen	hafen
ebene	ebene
anfang	anfangs
kaninchen	kaninchen
kern	kern
bindung	bindungs
schirm	schirm
härte	härte
bogen	bogen
stein	stein
tropfen	tropfen
wut	wut
ursprung	ursprungs
ärger	ärger
verein	vereins
versicherung	versicherungs
fabrik	fabrik
zorn	zorn
ding	ding
wirbel	wirbel
sichtbarkeit	sichtbarkeits
abzug	abzugs
reihe	reihen
entschluss	entschluss
stamm	stamm
fremde	fremden
erde	erd
loch	loch
gedanke	gedanken
wachsen	wachsen
zeile	zeilen
vergleich	vergleich
gleichung	gleichungs
ansicht	ansichts
angriff	angriffs
begriff	begriffs
schwung	schwung
datei	datein
stadt	stadt
speicherung	speicherungs
lied	lied
anzug	anzugs
kohle	kohlen
meldung	meldungs
verletzung	verletzungs
jahr	jahr
berg	berg
kaffee	kaffee
kiste	kisten
brief	brief
universität	universitäts
büro	büro
zahl	zahl
zahlen	zahlen
wirren	wirren
treffen	treffen
medien	medien
falle	fallen
lastwagen	lastwagen
karre	karren
anzahl	anzahl
strom	strom
ausfall	ausfall
umwelt	umwelt
schlag	schlag
hügel	hügel
knall	knall
fass	fass
preis	preis
lage	lagen
plan	plan
besuch	besuchs
taucher	taucher
ausland	auslands
markt	markt
reste	reste
ziel	ziel
adler	adler
schrott	schrott
abfall	abfall
angst	angst
klage	klage
mitschuld	mitschulds
dschungel	dschungel
mühe	mühe
bühne	bühne
obst	obst
anlage	anlagen
leine	leinen
brücke	brücken
schluss	schluss